EA ./textures/EA.xpm
WE ./textures/WE.xpm
NO ./textures/NO.xpm
SO ./textures/SO.xpm
C 120,206,10

F 116,102,59

11111111111111
10000000000001
1000000000N001
10000000000001
11111111111111